TILEMAP
225 16 							-- Size of tile map in tiles 15 height (224 + 17) width
16 16							-- Tile size & block size
images/blocks.png 	-- Tilesheet
16 1 -- Number of tiles in tilesheet --upperworld
000000000000000000000000000000000000000000000000000000000000000000000000000000000000000000000000000000000000000000000000000000000000000000000000000000000000000000000000000000000000000000000000000000000000000000000000000000000
000000000000000000000000000000000000000000000000000000000000000000000000000000000000000000000000000000000000000000000000000000000000000000000000000000000000000000000000000000000000000000000000000000a00000000000000000000000000
000000000000000000000000000000000000000000000000000000000000000000000000000000000000000000000000000000000000000000000000000000000000000000000000000000000000000000000000000000000000000000000000000000900000000000000000000000000
000000000000000000000000000000000000000000000000000000000000000000000000000000000000000000000000000000000000000000000000000000000000000000000000000000000000000000000000000000000000000000000000000000900000000000000000000000000
000000000000000000000020000000000000000000000000000000000000000000000000000000003333333300033320000000000000020000000000033300003223000000000000000000000000000000000000000000000000000000008800000000900000000000000000000000000
000000000000000000000000000000000000000000000000000000000000000000000000000000000000000000000000000000000000000000000000000000000000000000000000000000000000000000000000000000000000000000088800000000900000000000000000000000000
000000000000000000000000000000000000000000000000000000000000000000000000000000000000000000000000000000000000000000000000000000000000000000000000000000000000000000000000000000000000000000888800000000900000000000000000000000000
000000000000000000000000000000000000000000000000000000000000000000000000000000000000000000000000000000000000000000000000000000000000000000000000000000000000000000000000000000000000000008888800000000900000000000000000000000000
000000000000000020003232300000000000000000000056000000000560000000000000000003230000000000000030000033000020020020000030000000000330000008008000000000088008000000000000332300000000000088888800000000900000000000000000000000000
000000000000000000000000000000000000005600000047000000000470000000000000000000000000000000000000000000000000000000000000000000000000000088008800000000888008800000000000000000000000000888888800000000900000000000000000000000000
000000000000000000000000000056000000004700000047000000000470000000000000000000000000000000000000000000000000000000000000000000000000000888008880000008888008880000056000000000000005608888888800000000900000000000000000000000000
000000000000000000000000000047000000004700000047000000000470000000000000000000000000000000000000000000000000000000000000000000000000008888008888000088888008888000047000000000000004788888888800000000800000000000000000000000000
111111111111111111111111111111111111111111111111111111111111111111111001111111111111110001111111111111111111111111111111111111111111111111111111111111111001111111111111111111111111111111111111111111111111111111111111111111111
111111111111111111111111111111111111111111111111111111111111111111111001111111111111110001111111111111111111111111111111111111111111111111111111111111111001111111111111111111111111111111111111111111111111111111111111111111111
111111111111111111111111111111111111111111111111111111111111111111111001111111111111110001111111111111111111111111111111111111111111111111111111111111111001111111111111111111111111111111111111111111111111111111111111111111111
111111111111111111111111111111111111111111111111111111111111111111111001111111111111110001111111111111111111111111111111111111111111111111111111111111111001111111111111111111111111111111111111111111111111111111111111111111111

--underworld at the end of the previous section
-BACKground


0-> Air
1-> common block
2-> surprise block
3-> brick block
4-> left looking pipe
5-> left top looking pipe
6-> right top looking pipe
7-> right looking pipe
8-> flat block
9-> green pole
a-> top green pole
b-> left top open pipe
c-> left bottom open pipe
d-> horizontal top pipe
e-> horizontal bot pipe
f-> Blue 