TILEMAP
225 16 							-- Size of tile map in tiles 15 height (224 + 17) width
16 16							-- Tile size & block size
images/blocks.png 	-- Tilesheet
16 1 -- Number of tiles in tilesheet 
000000000000000000000000000000000000000000000000000000000000000000000000000000000000000000000000000000000000000000000000000000000000000000000000000000000000000000000000000000000000000000000000000000000000000000000000000000000
000000000000000000000000000000000000000000000000000000000000000000000000000000000000000000000000000000000000000000000000000000000000000000000000000000000000000000000000000000000000000000000000000000000000000000000000000000000
300000333333333333333333333333333333333333333333333333333333333333333333333333333333333333333333333333333333333333333333333333333333333330000000000000000000000333333333333333333333333333333333333333333333333333333333333333333
300000000000000000000000000000000000000000000000000000330033333300333300000033330000000000000000000000000000000000000000000000000000000000000000000000000000000000000004733333333000000000000000000000000000000000000000000000000
300000000000000000000000000000000000000000000000000000330033333300333300000033330000000000000000000000000000000000000000000000000000000000000000000000000000000000000004733333333000000000000000000000000000000000000000000000000
300000000000000000000000000000000000000000000000000033000000003300030000330000000000000000000000000000000000000000000000000000000000000000000000000000000000000000000004733333333000000000000000000000000000000000000000000000000
300000000000000000000000000000000000000000000000000033000000003300030000330000000003333330000000000000000000000000000000000000000000000000000000000000000000330000000004733333333000000000000000000000000000000000000000000000000
300000000000000000000000000000000000000303333030000033000000003300030300330000000003333330000000000000000000000000000000000000000000000000003000000000000000000000000004733333333000000000000000000000000000000000000000000000000
300000000000000000000000000003000000000303003030000033000000003300033300330033330000000000000000000000000000000000000000000000000000000000000000333333000000000000000bd4733333333000000000000000000000000000000000000000000000000
300000000022222000000008080000000000000333003330000033330033333300000000000000000000000000000000000000000000560000000000000000000000000880000000000000000000000000000ce4733333333000000000000000000000000000000000000000000000000
300000000000000000000808080800080000000000000000000000330000000000000000000000000000000000000000000000560000470000000000033000000000008880000000000000000000000333333333333333333000000000000000000000000000000000000000000000000
300000000000000000080808080800080800000000000000000000330000000000000000000000000000000000000000000000470000470000560000033000000000088880000000000000000000000333333333333333333000000000000000000000000000000000000000000000000
300000000000000008080808080800080800000000000000000000000000000000000000000000000000000000000000000000470000470000470000033000000000888880000000000000000000000333333333333333333000000000000000000000000000000000000000000000000
111111111111111111111111111111111111111111111111111111111111111111111111111111110001111111111111111111111111111111111110011001111111111110000000111111110000000111111111111111111111111111111111111111111111111111111111111111111
111111111111111111111111111111111111111111111111111111111111111111111111111111110001111111111111111111111111111111111110011001111111111110000000111111110000000111111111111111111111111111111111111111111111111111111111111111111
111111111111111111111111111111111111111111111111111111111111111111111111111111110001111111111111111111111111111111111110011001111111111110000000111111110000000111111111111111111111111111111111111111111111111111111111111111111
BACK
128 38 -- Tile and block size
images/test.png
1 1
000000000000000000000000000000000000000000000000000000000000000000000000000000000000000000000000000000000000000000000000000000000000000000000000000000000000000000000000000000000000000000000000000000000000000000000000000000000
000000000000000000000000000000000000000000000000000000000000000000000000000000000000000000000000000000000000000000000000000000000000000000000000000000000000000000000000000000000000000000000000000000000000000000000000000000000
000000000000000000000000000000000000000000000000000000000000000000000000000000000000000000000000000000000000000000000000000000000000000000000000000000000000000000000000000000000000000000000000000000000000000000000000000000000
000000000000000000000000000000000000000000000000000000000000000000000000000000000000000000000000000000000000000000000000000000000000000000000000000000000000000000000000000000000000000000000000000000000000000000000000000000000
000000000000000000000000000000000000000000000000000000000000000000000000000000000000000000000000000000000000000000000000000000000000000000000000000000000000000000000000000000000000000000000000000000000000000000000000000000000
000000000000000000000000000000000000000000000000000000000000000000000000000000000000000000000000000000000000000000000000000000000000000000000000000000000000000000000000000000000000000000000000000000000000000000000000000000000
000000000000000000000000000000000000000000000000000000000000000000000000000000000000000000000000000000000000000000000000000000000000000000000000000000000000000000000000000000000000000000000000000000000000000000000000000000000
000000000000000000000000000000000000000000000000000000000000000000000000000000000000000000000000000000000000000000000000000000000000000000000000000000000000000000000000000000000000000000000000000000000000000000000000000000000
000000000000000000000000000000000000000000000000000000000000000000000000000000000000000000000000000000000000000000000000000000000000000000000000000000000000000000000000000000000000000000000000000000000000000000000000000000000
000000000000000000000000000000000000000000000000000000000000000000000000000000000000000000000000000000000000000000000000000000000000000000000000000000000000000000000000000000000000000000000000000000000000000000000000000000000
000000000000000000000000000000000000000000000000000000000000000000000000000000000000000000000000000000000000000000000000000000000000000000000000000000000000000000000000000000000000000000000000000000000000000000000000000000000
000000000000000000000000000000000000000000000000000000000000000000000000000000000000000000000000000000000000000000000000000000000000000000000000000000000000000000000000000000000000000000000000000000000000000000000000000000000
000000000000000000000000000000000000000000000000000000000000000000000000000000000000000000000000000000000000000000000000000000000000000000000000000000000000000000000000000000000000000000000000000000000000000000000000000000000
000000000000000000000000000000000000000000000000000000000000000000000000000000000000000000000000000000000000000000000000000000000000000000000000000000000000000000000000000000000000000000000000000000000000000000000000000000000
000000000000000000000000000000000000000000000000000000000000000000000000000000000000000000000000000000000000000000000000000000000000000000000000000000000000000000000000000000000000000000000000000000000000000000000000000000000
000000000000000000000000000000000000000000000000000000000000000000000000000000000000000000000000000000000000000000000000000000000000000000000000000000000000000000000000000000000000000000000000000000000000000000000000000000000



0-> Air
1-> common block (blue)
2-> surprise block
3-> brick block (blue)
4-> left looking pipe
5-> left top looking pipe
6-> right top looking pipe
7-> right looking pipe
8-> flat block (blue)
9-> green pole
a-> top green pole
b-> left top open pipe
c-> left bottom open pipe
d-> horizontal top pipe
e-> horizontal bot pipe
f-> Blue 

k -> koopa
g -> goomba
M -> muntanya gran 1
m -> muntanya petita 2
N -> nuvol gran
n -> nuvol petit
T -> arbre gran
t -> arbre mitjà
y -> arbre petit
C -> credits
