TILEMAP
224 16 							-- Size of tile map in tiles 15 height (224 + 17) width
16 16							-- Tile size & block size
images/blocks.png 	-- Tilesheet
8 1 -- Number of tiles in tilesheet --upperworld
0000000000000000000000000000000000000000000000000000000000000000000000000000000000000000000000000000000000000000000000000000000000000000000000000000000000000000000000000000000000000000000000000000000000000000000000000000000030000000000000047
0000000000000000000000000000000000000000000000000000000000000000000000000000000000000000000000000000000000000000000000000000000000000000000000000000000000000000000000000000000000000000000000000000000000000000000000000000000030000000000000047
00000000000000000000000000000000000000000000000000000000000000000000000000000000000000000000000000000000000000000000000000000000000000000000000000000000000000000000000000000000000000000000000000000a0000000000000000000000000030000000000000047
0000000000000000000000000000000000000000000000000000000000000000000000000000000000000000000000000000000000000000000000000000000000000000000000000000000000000000000000000000000000000000000000000000090000000000000000000000000030000000000000047
0000000000000000000000000000000000000000000000000000000000000000000000000000000000000000000000000000000000000000000000000000000000000000000000000000000000000000000000000000000000000000000000000000090000000000000000000000000030000000000000047
0000000000000000000002000000000000000000000000000000000000000000000000000000000333333330003332000000000000002000000000003330000322300000000000000000000000000000000000000000000000000000000880000000090000000000000000000000000030000000000000047
0000000000000000000000000000000000000000000000000000000000000000000000000000000000000000000000000000000000000000000000000000000000000000000000000000000000000000000000000000000000000000008880000000090000000000000000000000000030000000000000047
0000000000000000000000000000000000000000000000000000000000000000000000000000000000000000000000000000000000000000000000000000000000000000000000000000000000000000000000000000000000000000088880000000090000000000000000000000000030000000000000047
0000000000000000000000000000000000000000000000000000000000000000000000000000000000000000000000000000000000000000000000000000000000000000000000000000000000000000000000000000000000000000888880000000090000000000000000000000000030000000000000047
0000000000000002000323230000000000000000000005600000000056000000000000000000323000000000000003000003300002002002000003000000000033000000800800000000008800800000000000033230000000000008888880000000090000000000000000000000000030000000000000047
0000000000000000000000000000000000000560000004700000000047000000000000000000000000000000000000000000000000000000000000000000000000000008800880000000088800880000000000000000000000000088888880000000090000000000000000000000000030000000000000047
0000000000000000000000000005600000000470000004700000000047000000000000000000000000000000000000000000000000000000000000000000000000000088800888000000888800888000005600000000000000560888888880000000090000000000000000000000000030000000000000047
0000000000000000000000000004700000000470000004700000000047000000000000000000000000000000000000000000000000000000000000000000000000000888800888800008888800888800004700000000000000478888888880000000080000000000000000000000000030000000000000047
1111111111111111111111111111111111111111111111111111111111111111111100111111111111111000111111111111111111111111111111111111111111111111111111111111111100111111111111111111111111111111111111111111111111111111111111111111111111111111111111111
1111111111111111111111111111111111111111111111111111111111111111111100111111111111111000111111111111111111111111111111111111111111111111111111111111111100111111111111111111111111111111111111111111111111111111111111111111111111111111111111111
1111111111111111111111111111111111111111111111111111111111111111111100111111111111111000111111111111111111111111111111111111111111111111111111111111111100111111111111111111111111111111111111111111111111111111111111111111111111111111111111111

--underworld at the end of the previous section
-BACKground


0-> Air
1-> common block
2-> surprise block
3-> brick block
4-> left looking pipe
5-> left top looking pipe
6-> right top looking pipe
7-> right looking pipe
8-> flat block
9-> green pole
a-> top green pole
b-> left top open pipe
c-> left bottom open pipe
d-> horizontal top pipe
e-> horizontal bot pipe
f-> Blue 